########################################
......................................##
......................................##
......................................##
..........################...........##
......................................#
......................................#
......................................#
.......................................#
.......................................#
.......................................#
.......................................#
.......#########.......................#
.......................................
........................................
.......................................
....############################........
.......................................
.......................................
.......................................
.......................................
.......................................
.......................................
..............########.................
#......................................
#.....................................#
#.....................................#
......................................#
......................................#
..........#############################
.......................................
.....................................